-N-xxx--------
|  \xx|      |
|   ---   L  |
W            E
|   ---      |
|  /xx|  L   |
| |xxx--------
-S-