---------------
|             |
x\     L      |
xx\   L L     E
xxx|          |
xxxW  --      |
xx/  /  \     |
x/  |    |    |
|    \    \   |
|     \   /   |
|             |
---------------