---N----
|      |
| L    |
W      E
|      |
|      |
|      |
---S----