----N-------
|          |
|   ----  L|
W     L|   |
|     L|   E
|   ----   |
------------